NO ./textures/bark.xpm
SO ./textures/bricks.xpm 
EA ./textures/wood.xpm
WE ./textures/wood.xpm

F 20,20,20
C 200,200,200

11111
10001
10S01
10001
10001
10001
11111




 1
101
 1

11111
11001
11001
10001
10001
10001
10001
10001
11111












1