NO ./textures/bark.xpm
SO ./textures/bricks.xpm 
EA ./textures/wood.xpm
WE ./textures/wood.xpm

F 32, 32, 32

C 0, 0, 102

11111111111111111   11111
1100000000000001   10001
10000000000000001   10001   
1000000000000000111110001   
1000000000000000000000001    
1000000000000000000000001
1000000000000000000000001
100000000000000000000001
1000000000000000000000001    1111
10000001000S000000000001    1001
100000111000000000000001    1111
1000000100000000000000001
1000000000000000000000001
1000000000000000000000001
1000000000000000000000001
100000000000000000000001
1000000000000000000000001
1000000000000000000000001
1000000000000000000000001
11111000000000000000000011111
    1000000000000000000000001
11111000000000000000000011111
10000000000000000000000001
1000000000000000000000001
1111111111111111111111111