


						NO       ./textures/bark.xpm
    SO 				./textures/bark.xpm
    	     	    EA ./textures/bark.xpm
	WE ./textures/bark.xpm









       F            32, 32, 32
				C						0, 0, 102

11111111
10000001
100N0001
11000001
11111111