11111111
10001001
10010001
10110001
11111001