11111111
10001001
10010N01
10110001
11111111
